type octile
height 26
width 18
map
......@...........
.....@.@..........
..@.@@..@.@.@.@...
........@......@@.
..................
.@....@...........
.....@..@.........
...@.......@.....@
...............@..
..................
.@........@.......
.@...@....@.......
.......@..........
.@...@@......@....
............@....@
.@.@..............
...@..............
.@................
....@...@.........
..@..@........@...
..@.........@.....
@............@..@.
..................
..@.............@.
..@.........@.@...
...@......@.......